FFFIFFFFSSFFFFFFFFFFFFTTTFFFFFFFFFFFFFFFFSSFFIFFFFF
FFFFFFFFFFFFFFFFFFFFFFFFFFFFFFFFFF000FFFFFFFFFFFFFF
FFFFFFFFFFFFFFFFFFFFFFFFF000000000000FFFFFFFFFFFFFF
FFFFFFFFFFFFFF000V000000000000000000FFFFFFFFFFFFFFF
FFFFHFFFFFFFFFFF0000000FFFFFFFFFFFFFFFFFFFFFFFFFFFF
FFFFFFFFFFFFFFFFFFFFFFFFFFFFFFFFFFFFFFFFFFFFFFFFFFF
FFFFFFFFFFFFFFFFFFFFFFFFFFFFFFFFFFFFFFFFFFF0000000F
FFFFFFFFFFFFFFFFFFFFFFFFFFFFFFFFFFFFFCFFFFFFFHFFFFF
FFFFFFFFFFFFFFFFFFFFFFFFFFFFFFFFFFFFFFFFFFFFFFFFFFF
FFFFFFFFFF0000000V0000000FFFFFFFFFFFFFFFFFFFFFFFFFF
FFFFFFFFFFFFFFFFF000000000000FFFFFFFFFFFFFFFFFFFFFF
FFFFFFFFFFFFFFFFFFFFFFFFFFFFFFFFFFFFFFFFFFFFFFFFFFF
FFFFFFFFFFFFFFFFFFFFFFFFFFFFFFFFFFFFFFFFFFFFFHFFFFF
FFFFFFFFFFFF0000000000FFFFF000000FFFFFFFFFFFFFFFFFF
FFHFFFFFFFFFFFFFFF000B00A000B000FFFFFFFFFFFFFFFFFFF
FFFFFFFFFFFFFFFFFFFF0000V0000FFFFFFFFFFFFFFFFFFFFFF
FFFFFFFFFFFFFFFFFFFFFFFFFFFFFFFFFFFFFFFFFFFFFFFFFFF
FFFFFFFFFFFFFFFFFFFFFFFFFFFFFFFFFFFFFFFFFFFFFFFFFFF
FFFFFFFFFFFFFFFFFFFFFFFFFFFFFFFFFFFFFFFFFFFFFFFFFFF
FFFFFFFFFFFFCFFFFFFFFFFFFFFFFFFFFFFFFFFFFFFFFFFFFFF
FFFFFFFFFFFFFFFFFFFFFFFFFFFFFFFFFFFFFFFFFFFFFFFFFFF
FFFFFFFFFFFFFFFFFFFFFFFFFFFFFFFFFFFFFFFFFFFFFFFFFFF
FFFFFFFFFFFFFFFFFFFFFFFFFFFFFFFFFFFFFFFFFFFFFFFFFFF
FFFFFFFFFFF0000000000000000000FFFFFFFFFFFFFFFFFFFFF
FFFFFFFFFFFFFFFFFFFFFFQ00000000000FFFFFFFFFFFFFFFFF
FFFFFFFFFFFFFFFFF0000000000000000VFFFFFFFFFFFFFFFFF
FFFFFFFFFFFFFFFFFFFFFFFFFFFFFFFFFFFFFFFFFFFFFFFFFFF
FFFFFFFFFFFFFFFFFFFFFFFFFFFFFFFFFFFFFFFFFFFFFFFFFFF
FFFFFFFFFFFFFFFFFFFFKKKFFFFFFFFFFFFFFFFFFFFFFFFFFFF
FFFKFFFFFFFPPFFFFGGGFFFFFFFFPPFFFFFFFFFFFFFFKFFFFFF
