0000000000000000000000000
0000FFFFF000000B000000000
0FFFFFHFFF000B000BB000000
00FFFFF0C0000000000000000
0000000000000000000000000
0000000000000000000000000
00000000000A0000000000000
0000000000000000000000000
0000000000000000000000000
0000000000000000000000000
000000000000V000000000000
0000000000000000000000000