N000I00T00000000000000000000000000000000000000
000S000000000000000000000000000000000000000000
0S0000I000000V00000000000000000000000000000000
0000T00C00000000000000000000000000000000000000
000I0000HFFFFFFF00000000000000000FFFFFFFF00000
000CFFFFFFFFFF000000000000000000FFFFFH00000000
0000000000000000000HFF0000Q000000FFFFFFFFF0000
000000000FF0000000000000000000000FFFFFH0000000
00000FFFFFF000000000BBBBBBB000000FFFFFFFFFFF00
00000000000000000000000A0000000000000000000000
0000000000000000000BBBBBBBBB000000000000000000
000Q0000V0000000000000000000000000000000000000
0000000000000000000000000000000000000000000000
00FFFFFFFFFFFFFFFFFFF0000000000000000000K00000
000FFFFFFFFFFFFFFFFFFF00000000000FF00C000G0000
00000FFFFFFFFFFFFFFFFFF00000000FFFFF000K0000P0
00000000000000000000000000000HH000FF000000P000
00000000V00000000000000000000000000000G00K000M
***
is_winter