I0000000000000000000000
0000FFFFF000000B0000000
0FFFFFHFFF000B000BB000K
00FFFFSSC0000000000000K
00000000000000000000000
00000000000000000000T00
00000000000A00000000000
00000000000000000000000
00000000000000000000000
00000000000000000G00000
000000000000V0000000000
00000000000000000000000
***
is_winter