##############################################################################
#............................................................................#
#............................................................................#
#......@.....................................................................#
#............................................................................#
#............................................................................#
#............................................................................#
#............................................................................#
#............................................................................#
#............................................................................#
#............................................................................#
#............................................................................#
#............................................................................#
#............................................................................#
#............................................................................#
#............................................................................#
##############################################################################